R 800 400
NO ./textures/sponge.png
SO ./textures/sponge.png
WE ./textures/sponge.png
EA ./textures/sponge.png
S ./textures/sponge.png
F 220,100,0
C 225,30,0
111111
110011
100001
1000N1
111111