NO ./textures/sponge.png
SO ./textures/sponge.png
WE ./textures/sponge.png
EA ./textures/sponge.png
S ./textures/sponge.png
F 220,100,0
C 225,30,0
   1111111
1111101001
1000002001
1000N11111
111111
