R 800 400
NO ./textures/wool_colored_light_blue.png
SO ./textures/wool_colored_lime.png
WE ./textures/wool_colored_red.png
EA ./textures/wool_colored_yellow.png
S ./textures/sponge.png
F 220,100,0
C 225,30,0
1111111111
1100001011
1000000101
10001000E1
1111111111
