R 800 400
NO ./textures/wool_colored_light_blue.png
SO ./textures/wool_colored_lime.png
WE ./textures/wool_colored_red.png
EA ./textures/wool_colored_yellow.png
S ./textures/sponge.png
F 220,100,0
C 225,30,0
11111111111111111111111
11000010100000000000001
11000010100000000000001
11000010100000000000001
11000010100000000000001
11000010100000000000001
11000010100000000000001
11000010100000000000001
11000010100000000000001
10000001000000000000001
10001000E00000000000001
11111111111111111111111
