NO ./textures/wool_colored_light_blue.png
SO ./textures/wool_colored_lime.png
WE ./textures/wool_colored_red.png
EA ./textures/wool_colored_yellow.png
F 220,100,0
C 225,30,0
11111111111111111111111111111
10000000001100000000000000001
10110000011100000010000010001
10010000000000000000000010001
10110000011100000010000010001
10000000001100000111011110001
11110111111111011100000010001
11110111111111011101010010001
11000000110101011100000010001
10000000000000001100000010001
10000000000000001101010010001
11000000110101011111101110N01
11110111111101011111011110001
11111111111111111111111111111
11111111111111111111111111111
