WE ./textures/world.png
EA ./textures/magical_forest.png
NO ./textures/mush.png
SO ./textures/forest.png
F 85,107,47
C 32,178,170
1111111111
1111101001
1000002001
1000001111
1000000001
1000000001
1111100001
1000000001
1111112111
1001000001
1001000001
1000000001
1001111111
1001111111
1000000001
1000000N01
1111111111
