WE ./textures/no_square.png
EA ./textures/no_square.png
NO ./textures/no_square_ver.png
SO ./textures/no_square_ver.png
F 0,50,17
C 125,196,149
111111
11001111
100001
1000N1
111111
