WE ./textures/wool_colored_yellow.png
EA ./textures/wool_colored_light_blue.png
NO ./textures/wool_colored_lime.png
SO ./textures/wool_colored_red.png
F 220,100,0
C 225,30,0
111111
11001111
100001
1000N1
111111
